Author,Year,case1,case0,case-totol,control1,control0,control-total,polymorphism,model,country,ethnicity
Ghasemi,2020,29,271,300,64,326,390,DICER A>G rs3742330,Allele model,Iran,Caucasian
Mohseni,2018,25,175,200,30,170,200,DICER A>G rs3742330,Allele model,Iran,Caucasian
Fu,2017,162,272,434,265,515,780,DICER A>G rs3742330,Allele model,China,Asian
Jung,2014,286,390,676,193,273,466,DICER A>G rs3742330,Allele model,Korea,Asian
Ghasemi,2020,27,123,150,58,137,195,DICER A>G rs3742330,Dominant model,Iran,Caucasian
Mohseni,2018,25,75,100,30,70,100,DICER A>G rs3742330,Dominant model,Iran,Caucasian
Fu,2017,128,89,217,222,168,390,DICER A>G rs3742330,Dominant model,China,Asian
Jung,2014,219,119,338,158,75,233,DICER A>G rs3742330,Dominant model,Korea,Asian
Ghasemi,2020,2,148,150,6,189,195,DICER A>G rs3742330,Recessive model,Iran,Caucasian
Mohseni,2018,0,100,100,0,100,100,DICER A>G rs3742330,Recessive model,Iran,Caucasian
Fu,2017,34,183,217,43,347,390,DICER A>G rs3742330,Recessive model,China,Asian
Jung,2014,67,271,338,35,198,233,DICER A>G rs3742330,Recessive model,Korea,Asian
Ghasemi,2020,2,123,125,6,137,143,DICER A>G rs3742330,Homozygotic model,Iran,Caucasian
Mohseni,2018,0,75,75,0,70,70,DICER A>G rs3742330,Homozygotic model,Iran,Caucasian
Fu,2017,34,89,123,43,168,211,DICER A>G rs3742330,Homozygotic model,China,Asian
Jung,2014,67,119,186,35,75,110,DICER A>G rs3742330,Homozygotic model,Korea,Asian
Ghasemi,2020,25,123,148,52,137,189,DICER A>G rs3742330,Heterozygotic model,Iran,Caucasian
Mohseni,2018,25,75,100,30,70,100,DICER A>G rs3742330,Heterozygotic model,Iran,Caucasian
Fu,2017,94,89,183,179,168,347,DICER A>G rs3742330,Heterozygotic model,China,Asian
Jung,2014,152,119,271,123,75,198,DICER A>G rs3742330,Heterozygotic model,Korea,Asian
Mohseni,2018,65,135,200,76,124,200,DROSHA T>C rs10719,Allele model,Iran,Caucasian
Fu,2017,141,293,434,277,503,780,DROSHA T>C rs10719,Allele model,China,Asian
Jung,2014,204,472,676,148,328,476,DROSHA T>C rs10719,Allele model,Korea,Asian
Mohseni,2018,57,43,100,73,27,100,DROSHA T>C rs10719,Dominant model,Iran,Caucasian
Fu,2017,121,96,217,225,165,390,DROSHA T>C rs10719,Dominant model,China,Asian
Jung,2014,177,161,338,128,110,238,DROSHA T>C rs10719,Dominant model,Korea,Asian
Peng,2022,7,93,100,15,57,72,DROSHA T>C rs10719,Recessive model,China,Asian
Mohseni,2018,8,92,100,3,97,100,DROSHA T>C rs10719,Recessive model,Iran,Caucasian
Fu,2017,20,197,217,52,338,390,DROSHA T>C rs10719,Recessive model,China,Asian
Jung,2014,27,311,338,20,218,238,DROSHA T>C rs10719,Recessive model,Korea,Asian
Mohseni,2018,8,43,51,3,27,30,DROSHA T>C rs10719,Homozygotic model,Iran,Caucasian
Fu,2017,20,96,116,52,165,217,DROSHA T>C rs10719,Homozygotic model,China,Asian
Jung,2014,27,161,188,20,110,130,DROSHA T>C rs10719,Homozygotic model,Korea,Asian
Mohseni,2018,49,43,92,70,27,97,DROSHA T>C rs10719,Heterozygotic model,Iran,Caucasian
Fu,2017,101,96,197,173,165,338,DROSHA T>C rs10719,Heterozygotic model,China,Asian
Jung,2014,150,161,311,108,110,218,DROSHA T>C rs10719,Heterozygotic model,Korea,Asian
Mortazavifar,2020,58,142,200,60,140,200,RAN C>T rs14035,Allele model,Iran,Caucasian
Tohidi,2018,33,167,200,32,168,200,RAN C>T rs14035,Allele model,Iran,Caucasian
Fu,2017,95,339,434,181,599,780,RAN C>T rs14035,Allele model,China,Asian
Jung,2014,143,533,676,126,350,476,RAN C>T rs14035,Allele model,Korea,Asian
Mortazavifar,2020,49,51,100,49,51,100,RAN C>T rs14035,Dominant model,Iran,Caucasian
Tohidi,2018,29,71,100,26,74,100,RAN C>T rs14035,Dominant model,Iran,Caucasian
Fu,2017,86,131,217,166,224,390,RAN C>T rs14035,Dominant model,China,Asian
Jung,2014,128,210,338,115,123,238,RAN C>T rs14035,Dominant model,Korea,Asian
Mortazavifar,2020,9,91,100,11,89,100,RAN C>T rs14035,Recessive model,Iran,Caucasian
Tohidi,2018,4,96,100,6,94,100,RAN C>T rs14035,Recessive model,Iran,Caucasian
Fu,2017,9,208,217,15,375,390,RAN C>T rs14035,Recessive model,China,Asian
Jung,2014,15,323,338,11,227,238,RAN C>T rs14035,Recessive model,Korea,Asian
Mortazavifar,2020,9,51,60,11,51,62,RAN C>T rs14035,Homozygotic model,Iran,Caucasian
Tohidi,2018,4,71,75,6,74,80,RAN C>T rs14035,Homozygotic model,Iran,Caucasian
Fu,2017,9,131,140,15,224,239,RAN C>T rs14035,Homozygotic model,China,Asian
Jung,2014,15,210,225,11,123,134,RAN C>T rs14035,Homozygotic model,Korea,Asian
Mortazavifar,2020,40,51,91,38,51,89,RAN C>T rs14035,Heterozygotic model,Iran,Caucasian
Tohidi,2018,25,71,96,20,74,94,RAN C>T rs14035,Heterozygotic model,Iran,Caucasian
Fu,2017,77,131,208,151,224,375,RAN C>T rs14035,Heterozygotic model,China,Asian
Jung,2014,113,210,323,104,123,227,RAN C>T rs14035,Heterozygotic model,Korea,Asian
An,2022,104,658,762,52,510,562,miR-10a A>T rs3809783,Allele model,Korea,Asian
Vahedi,2022,70,162,232,36,142,178,miR-10a A>T rs3809783,Allele model,Iran,Caucasian
Li,2016,97,303,400,46,354,400,miR-10a A>T rs3809783,Allele model,China,Asian
An,2022,96,285,381,51,230,281,miR-10a A>T rs3809783,Dominant model,Korea,Asian
Vahedi,2022,63,53,116,33,56,89,miR-10a A>T rs3809783,Dominant model,Iran,Caucasian
Li,2016,97,103,200,46,154,200,miR-10a A>T rs3809783,Dominant model,China,Asian
An,2022,8,373,381,1,280,281,miR-10a A>T rs3809783,Recessive model,Korea,Asian
Vahedi,2022,7,109,116,3,86,89,miR-10a A>T rs3809783,Recessive model,Iran,Caucasian
Li,2016,0,200,200,0,200,200,miR-10a A>T rs3809783,Recessive model,China,Asian
An,2022,8,285,293,1,230,231,miR-10a A>T rs3809783,Homozygotic model,Korea,Asian
Vahedi,2022,7,53,60,3,56,59,miR-10a A>T rs3809783,Homozygotic model,Iran,Caucasian
Li,2016,0,103,103,0,154,154,miR-10a A>T rs3809783,Homozygotic model,China,Asian
An,2022,88,285,373,50,230,280,miR-10a A>T rs3809783,Heterozygotic model,Korea,Asian
Vahedi,2022,56,53,109,30,56,86,miR-10a A>T rs3809783,Heterozygotic model,Iran,Caucasian
Li,2016,97,103,200,46,154,200,miR-10a A>T rs3809783,Heterozygotic model,China,Asian
Ezat,2022,190,260,450,213,237,450,miR-124 C>G rs531564,Allele model,Iraq,Caucasian
Park,2019,110,640,750,95,457,552,miR-124 C>G rs531564,Allele model,Korea,Asian
Ezat,2022,154,71,225,171,54,225,miR-124 C>G rs531564,Dominant model,Iraq,Caucasian
Park,2019,99,276,375,88,188,276,miR-124 C>G rs531564,Dominant model,Korea,Asian
Ezat,2022,36,189,225,42,183,225,miR-124 C>G rs531564,Recessive model,Iraq,Caucasian
Park,2019,11,364,375,7,269,276,miR-124 C>G rs531564,Recessive model,Korea,Asian
Ezat,2022,36,71,107,42,54,96,miR-124 C>G rs531564,Homozygotic model,Iraq,Caucasian
Park,2019,11,276,287,7,188,195,miR-124 C>G rs531564,Homozygotic model,Korea,Asian
Ezat,2022,118,71,189,129,54,183,miR-124 C>G rs531564,Heterozygotic model,Iraq,Caucasian
Park,2019,88,276,364,81,188,269,miR-124 C>G rs531564,Heterozygotic model,Korea,Asian
Vahedi,2022,81,151,232,39,139,178,miR-125a G>A rs41275794,Allele model,Iraq,Caucasian
Hu,2014,239,501,740,190,1072,1262,miR-125a G>A rs41275794,Allele model,China,Asian
Hu,2011,95,333,428,128,734,862,miR-125a G>A rs41275794,Allele model,China,Asian
Vahedi,2022,70,46,116,35,54,89,miR-125a G>A rs41275794,Dominant model,Iraq,Caucasian
Hu,2014,229,141,370,181,450,631,miR-125a G>A rs41275794,Dominant model,China,Asian
Hu,2011,92,122,214,121,310,431,miR-125a G>A rs41275794,Dominant model,China,Asian
Vahedi,2022,11,105,116,4,85,89,miR-125a G>A rs41275794,Recessive model,Iraq,Caucasian
Hu,2014,10,360,370,9,622,631,miR-125a G>A rs41275794,Recessive model,China,Asian
Hu,2011,3,211,214,7,424,431,miR-125a G>A rs41275794,Recessive model,China,Asian
Vahedi,2022,11,46,57,4,54,58,miR-125a G>A rs41275794,Homozygotic model,Iraq,Caucasian
Hu,2014,10,141,151,9,450,459,miR-125a G>A rs41275794,Homozygotic model,China,Asian
Hu,2011,3,122,125,7,310,317,miR-125a G>A rs41275794,Homozygotic model,China,Asian
Vahedi,2022,59,46,105,31,54,85,miR-125a G>A rs41275794,Heterozygotic model,Iraq,Caucasian
Hu,2014,219,141,360,172,450,622,miR-125a G>A rs41275794,Heterozygotic model,China,Asian
Hu,2011,89,122,211,114,310,424,miR-125a G>A rs41275794,Heterozygotic model,China,Asian
Manzoor,2022,172,128,300,235,125,360,miR-125a C>T rs12976445,Allele model,India,Caucasian
Lee,2020,105,617,722,75,469,544,miR-125a C>T rs12976445,Allele model,Korea,Asian
Vahedi,2020,167,65,232,139,39,178,miR-125a C>T rs12976445,Allele model,Iran,Caucasian
Hu,2014,214,526,740,251,1011,1262,miR-125a C>T rs12976445,Allele model,China,Asian
Hu,2011,106,322,428,155,707,862,miR-125a C>T rs12976445,Allele model,China,Asian
Manzoor,2022,121,29,150,161,19,180,miR-125a C>T rs12976445,Dominant model,India,Caucasian
Lee,2020,98,263,361,69,203,272,miR-125a C>T rs12976445,Dominant model,Korea,Asian
Vahedi,2020,108,8,116,87,2,89,miR-125a C>T rs12976445,Dominant model,Iran,Caucasian
Hu,2014,212,158,370,239,392,631,miR-125a C>T rs12976445,Dominant model,China,Asian
Hu,2011,103,111,214,146,285,431,miR-125a C>T rs12976445,Dominant model,China,Asian
Manzoor,2022,51,99,150,74,106,180,miR-125a C>T rs12976445,Recessive model,India,Caucasian
Lee,2020,7,354,361,6,266,272,miR-125a C>T rs12976445,Recessive model,Korea,Asian
Vahedi,2020,59,57,116,52,37,89,miR-125a C>T rs12976445,Recessive model,Iran,Caucasian
Hu,2014,2,368,370,12,619,631,miR-125a C>T rs12976445,Recessive model,China,Asian
Hu,2011,3,211,214,9,422,431,miR-125a C>T rs12976445,Recessive model,China,Asian
Manzoor,2022,51,29,80,74,19,93,miR-125a C>T rs12976445,Homozygotic model,India,Caucasian
Lee,2020,7,263,270,6,203,209,miR-125a C>T rs12976445,Homozygotic model,Korea,Asian
Vahedi,2020,59,8,67,52,2,54,miR-125a C>T rs12976445,Homozygotic model,Iran,Caucasian
Hu,2014,2,158,160,12,392,404,miR-125a C>T rs12976445,Homozygotic model,China,Asian
Hu,2011,3,111,114,9,285,294,miR-125a C>T rs12976445,Homozygotic model,China,Asian
Manzoor,2022,70,29,99,87,19,106,miR-125a C>T rs12976445,Heterozygotic model,India,Caucasian
Lee,2020,91,263,354,63,203,266,miR-125a C>T rs12976445,Heterozygotic model,Korea,Asian
Vahedi,2020,49,8,57,35,2,37,miR-125a C>T rs12976445,Heterozygotic model,Iran,Caucasian
Hu,2014,210,158,368,227,392,619,miR-125a C>T rs12976445,Heterozygotic model,China,Asian
Hu,2011,100,111,211,137,285,422,miR-125a C>T rs12976445,Heterozygotic model,China,Asian
Babakhanzadeh,2021,139,289,428,79,215,294,miR-146a C>G rs2910164,Allele model,Iran,Caucasian
Alipour,2019,43,197,240,48,132,180,miR-146a C>G rs2910164,Allele model,Iran,Caucasian
Parveen,2015,167,233,400,228,372,600,miR-146a C>G rs2910164,Allele model,India,Caucasian
Jeon,2012,270,390,660,185,283,468,miR-146a C>G rs2910164,Allele model,Korea,Asian
Babakhanzadeh,2021,122,92,214,69,78,147,miR-146a C>G rs2910164,Dominant model,Iran,Caucasian
Alipour,2019,39,81,120,45,45,90,miR-146a C>G rs2910164,Dominant model,Iran,Caucasian
Parveen,2015,137,63,200,192,108,300,miR-146a C>G rs2910164,Dominant model,India,Caucasian
Jeon,2012,214,116,330,155,79,234,miR-146a C>G rs2910164,Dominant model,Korea,Asian
Babakhanzadeh,2021,17,197,214,10,137,147,miR-146a C>G rs2910164,Recessive model,Iran,Caucasian
Alipour,2019,4,116,120,3,87,90,miR-146a C>G rs2910164,Recessive model,Iran,Caucasian
Parveen,2015,30,170,200,36,264,300,miR-146a C>G rs2910164,Recessive model,India,Caucasian
Jeon,2012,56,274,330,30,204,234,miR-146a C>G rs2910164,Recessive model,Korea,Asian
Babakhanzadeh,2021,17,92,109,10,78,88,miR-146a C>G rs2910164,Homozygotic model,Iran,Caucasian
Alipour,2019,4,81,85,3,45,48,miR-146a C>G rs2910164,Homozygotic model,Iran,Caucasian
Parveen,2015,30,63,93,36,108,144,miR-146a C>G rs2910164,Homozygotic model,India,Caucasian
Jeon,2012,56,116,172,30,79,109,miR-146a C>G rs2910164,Homozygotic model,Korea,Asian
Babakhanzadeh,2021,105,92,197,59,78,137,miR-146a C>G rs2910164,Heterozygotic model,Iran,Caucasian
Alipour,2019,35,81,116,42,45,87,miR-146a C>G rs2910164,Heterozygotic model,Iran,Caucasian
Parveen,2015,107,63,170,156,108,264,miR-146a C>G rs2910164,Heterozygotic model,India,Caucasian
Jeon,2012,158,116,274,125,79,204,miR-146a C>G rs2910164,Heterozygotic model,Korea,Asian
Stavros,2022,126,272,398,122,278,400,miR-149 T>C rs2292832,Allele model,Greece,Caucasian
Alipour,2019,52,188,240,23,157,180,miR-149 T>C rs2292832,Allele model,Iran,Caucasian
Parveen,2015,82,318,400,102,498,600,miR-149 T>C rs2292832,Allele model,India,Caucasian
Jeon,2012,183,477,660,116,352,468,miR-149 T>C rs2292832,Allele model,Korea,Asian
Stavros,2022,97,102,199,90,110,200,miR-149 T>C rs2292832,Dominant model,Greece,Caucasian
Alipour,2019,50,70,120,22,68,90,miR-149 T>C rs2292832,Dominant model,Iran,Caucasian
Parveen,2015,72,128,200,93,207,300,miR-149 T>C rs2292832,Dominant model,India,Caucasian
Jeon,2012,157,173,330,102,132,234,miR-149 T>C rs2292832,Dominant model,Korea,Asian
Stavros,2022,29,170,199,32,168,200,miR-149 T>C rs2292832,Recessive model,Greece,Caucasian
Alipour,2019,2,118,120,1,89,90,miR-149 T>C rs2292832,Recessive model,Iran,Caucasian
Parveen,2015,10,190,200,9,291,300,miR-149 T>C rs2292832,Recessive model,India,Caucasian
Jeon,2012,26,304,330,14,220,234,miR-149 T>C rs2292832,Recessive model,Korea,Asian
Stavros,2022,29,102,131,32,110,142,miR-149 T>C rs2292832,Homozygotic model,Greece,Caucasian
Alipour,2019,2,70,72,1,68,69,miR-149 T>C rs2292832,Homozygotic model,Iran,Caucasian
Parveen,2015,10,128,138,9,207,216,miR-149 T>C rs2292832,Homozygotic model,India,Caucasian
Jeon,2012,26,173,199,14,132,146,miR-149 T>C rs2292832,Homozygotic model,Korea,Asian
Stavros,2022,68,102,170,58,110,168,miR-149 T>C rs2292832,Heterozygotic model,Greece,Caucasian
Alipour,2019,48,70,118,21,68,89,miR-149 T>C rs2292832,Heterozygotic model,Iran,Caucasian
Parveen,2015,62,128,190,84,207,291,miR-149 T>C rs2292832,Heterozygotic model,India,Caucasian
Jeon,2012,131,173,304,88,132,220,miR-149 T>C rs2292832,Heterozygotic model,Korea,Asian
Ivani,2022,35,51,86,50,110,160,miR-196a2 C>T rs11614913,Allele model,Iran,Caucasian
Babakhanzadeh,2021,121,307,428,100,194,294,miR-196a2 C>T rs11614913,Allele model,Iran,Caucasian
Wang,2020,352,248,600,319,307,626,miR-196a2 C>T rs11614913,Allele model,China,Asian
Alipour,2019,206,34,240,160,20,180,miR-196a2 C>T rs11614913,Allele model,Iran,Caucasian
Stavrou,2018,179,91,270,133,61,194,miR-196a2 C>T rs11614913,Allele model,Greece,Caucasian
Fazli,2018,81,119,200,80,120,200,miR-196a2 C>T rs11614913,Allele model,Iran,Caucasian
Beidokhti,2017,164,236,400,132,268,400,miR-196a2 C>T rs11614913,Allele model,Iran,Caucasian
Parveen,2015,225,175,400,366,234,600,miR-196a2 C>T rs11614913,Allele model,India,Caucasian
Jeon,2012,337,323,660,257,211,468,miR-196a2 C>T rs11614913,Allele model,Korea,Asian
Ivani,2022,29,14,43,44,36,80,miR-196a2 C>T rs11614913,Dominant model,Iran,Caucasian
Babakhanzadeh,2021,110,104,214,85,62,147,miR-196a2 C>T rs11614913,Dominant model,Iran,Caucasian
Wang,2020,246,54,300,237,76,313,miR-196a2 C>T rs11614913,Dominant model,China,Asian
Alipour,2019,117,3,120,89,1,90,miR-196a2 C>T rs11614913,Dominant model,Iran,Caucasian
Stavrou,2018,120,15,135,89,8,97,miR-196a2 C>T rs11614913,Dominant model,Greece,Caucasian
Fazli,2018,67,33,100,71,29,100,miR-196a2 C>T rs11614913,Dominant model,Iran,Caucasian
Beidokhti,2017,132,68,200,116,84,200,miR-196a2 C>T rs11614913,Dominant model,Iran,Caucasian
Parveen,2015,160,40,200,262,38,300,miR-196a2 C>T rs11614913,Dominant model,India,Caucasian
Jeon,2012,248,82,330,193,41,234,miR-196a2 C>T rs11614913,Dominant model,Korea,Asian
Ivani,2022,6,37,43,6,74,80,miR-196a2 C>T rs11614913,Recessive model,Iran,Caucasian
Babakhanzadeh,2021,11,203,214,15,132,147,miR-196a2 C>T rs11614913,Recessive model,Iran,Caucasian
Wang,2020,106,194,300,82,231,313,miR-196a2 C>T rs11614913,Recessive model,China,Asian
Alipour,2019,89,31,120,71,19,90,miR-196a2 C>T rs11614913,Recessive model,Iran,Caucasian
Stavrou,2018,59,76,135,44,53,97,miR-196a2 C>T rs11614913,Recessive model,Greece,Caucasian
Fazli,2018,14,86,100,9,91,100,miR-196a2 C>T rs11614913,Recessive model,Iran,Caucasian
Beidokhti,2017,32,168,200,16,184,200,miR-196a2 C>T rs11614913,Recessive model,Iran,Caucasian
Parveen,2015,65,135,200,104,196,300,miR-196a2 C>T rs11614913,Recessive model,India,Caucasian
Jeon,2012,89,241,330,64,170,234,miR-196a2 C>T rs11614913,Recessive model,Korea,Asian
Ivani,2022,6,14,20,6,36,42,miR-196a2 C>T rs11614913,Homozygotic model,Iran,Caucasian
Babakhanzadeh,2021,11,104,115,15,62,77,miR-196a2 C>T rs11614913,Homozygotic model,Iran,Caucasian
Wang,2020,106,54,160,82,76,158,miR-196a2 C>T rs11614913,Homozygotic model,China,Asian
Alipour,2019,89,3,92,71,1,72,miR-196a2 C>T rs11614913,Homozygotic model,Iran,Caucasian
Stavrou,2018,59,15,74,44,8,52,miR-196a2 C>T rs11614913,Homozygotic model,Greece,Caucasian
Fazli,2018,14,33,47,9,29,38,miR-196a2 C>T rs11614913,Homozygotic model,Iran,Caucasian
Beidokhti,2017,32,68,100,16,84,100,miR-196a2 C>T rs11614913,Homozygotic model,Iran,Caucasian
Parveen,2015,65,40,105,104,38,142,miR-196a2 C>T rs11614913,Homozygotic model,India,Caucasian
Jeon,2012,89,82,171,64,41,105,miR-196a2 C>T rs11614913,Homozygotic model,Korea,Asian
Ivani,2022,23,14,37,38,36,74,miR-196a2 C>T rs11614913,Heterozygotic model,Iran,Caucasian
Babakhanzadeh,2021,99,104,203,70,62,132,miR-196a2 C>T rs11614913,Heterozygotic model,Iran,Caucasian
Wang,2020,140,54,194,155,76,231,miR-196a2 C>T rs11614913,Heterozygotic model,China,Asian
Alipour,2019,28,3,31,18,1,19,miR-196a2 C>T rs11614913,Heterozygotic model,Iran,Caucasian
Stavrou,2018,61,15,76,45,8,53,miR-196a2 C>T rs11614913,Heterozygotic model,Greece,Caucasian
Fazli,2018,53,33,86,62,29,91,miR-196a2 C>T rs11614913,Heterozygotic model,Iran,Caucasian
Beidokhti,2017,100,68,168,100,84,184,miR-196a2 C>T rs11614913,Heterozygotic model,Iran,Caucasian
Parveen,2015,95,40,135,158,38,196,miR-196a2 C>T rs11614913,Heterozygotic model,India,Caucasian
Jeon,2012,159,82,241,129,41,170,miR-196a2 C>T rs11614913,Heterozygotic model,Korea,Asian
Stavros,2022,192,206,398,132,268,400,miR-27a A>G rs895819,Allele model,Greece,Caucasian
Shaker,2020,97,101,198,58,142,200,miR-27a A>G rs895819,Allele model,Egypt,Caucasian
Rah,2017,272,502,774,182,268,450,miR-27a A>G rs895819,Allele model,Korea,Asian
Wang,2016,104,172,276,77,207,284,miR-27a A>G rs895819,Allele model,China,Asian
Stavros,2022,141,58,199,113,87,200,miR-27a A>G rs895819,Dominant model,Greece,Caucasian
Shaker,2020,65,34,99,44,56,100,miR-27a A>G rs895819,Dominant model,Egypt,Caucasian
Rah,2017,221,166,387,151,74,225,miR-27a A>G rs895819,Dominant model,Korea,Asian
Wang,2016,82,56,138,64,78,142,miR-27a A>G rs895819,Dominant model,China,Asian
Stavros,2022,51,148,199,19,181,200,miR-27a A>G rs895819,Recessive model,Greece,Caucasian
Shaker,2020,32,67,99,14,86,100,miR-27a A>G rs895819,Recessive model,Egypt,Caucasian
Rah,2017,51,336,387,31,194,225,miR-27a A>G rs895819,Recessive model,Korea,Asian
Wang,2016,22,116,138,13,129,142,miR-27a A>G rs895819,Recessive model,China,Asian
Stavros,2022,51,58,109,19,87,106,miR-27a A>G rs895819,Homozygotic model,Greece,Caucasian
Shaker,2020,32,34,66,14,56,70,miR-27a A>G rs895819,Homozygotic model,Egypt,Caucasian
Rah,2017,51,166,217,31,74,105,miR-27a A>G rs895819,Homozygotic model,Korea,Asian
Wang,2016,22,56,78,13,78,91,miR-27a A>G rs895819,Homozygotic model,China,Asian
Stavros,2022,90,58,148,94,87,181,miR-27a A>G rs895819,Heterozygotic model,Greece,Caucasian
Shaker,2020,33,34,67,30,56,86,miR-27a A>G rs895819,Heterozygotic model,Egypt,Caucasian
Rah,2017,170,166,336,120,74,194,miR-27a A>G rs895819,Heterozygotic model,Korea,Asian
Wang,2016,60,56,116,51,78,129,miR-27a A>G rs895819,Heterozygotic model,China,Asian
Vahedi,2022,67,165,232,37,141,178,miR-323b T>A rs56103835,Allele model,Iran,Caucasian
Wang,2018,160,252,412,112,252,364,miR-323b T>A rs56103835,Allele model,China,Asian
Vahedi,2022,56,60,116,34,55,89,miR-323b T>A rs56103835,Dominant model,Iran,Caucasian
Wang,2018,134,72,206,94,88,182,miR-323b T>A rs56103835,Dominant model,China,Asian
Vahedi,2022,11,105,116,3,86,89,miR-323b T>A rs56103835,Recessive model,Iran,Caucasian
Wang,2018,26,180,206,18,164,182,miR-323b T>A rs56103835,Recessive model,China,Asian
Vahedi,2022,11,60,71,3,55,58,miR-323b T>A rs56103835,Homozygotic model,Iran,Caucasian
Wang,2018,26,72,98,18,88,106,miR-323b T>A rs56103835,Homozygotic model,China,Asian
Vahedi,2022,45,60,105,31,55,86,miR-323b T>A rs56103835,Heterozygotic model,Iran,Caucasian
Wang,2018,108,72,180,76,88,164,miR-323b T>A rs56103835,Heterozygotic model,China,Asian
Wang,2019,80,552,632,115,503,618,miR-423 C>A rs6505162,Allele model,China,Asian
Rah,2017,180,594,774,87,363,450,miR-423 C>A rs6505162,Allele model,Korea,Asian
Su,2015,82,268,350,62,340,402,miR-423 C>A rs6505162,Allele model,China,Asian
Wang,2019,76,240,316,103,206,309,miR-423 C>A rs6505162,Dominant model,China,Asian
Rah,2017,155,232,387,76,149,225,miR-423 C>A rs6505162,Dominant model,Korea,Asian
Wang,2019,4,312,316,12,297,309,miR-423 C>A rs6505162,Recessive model,China,Asian
Rah,2017,25,362,387,11,214,225,miR-423 C>A rs6505162,Recessive model,Korea,Asian
Wang,2019,4,240,244,12,206,218,miR-423 C>A rs6505162,Homozygotic model,China,Asian
Rah,2017,25,232,257,11,149,160,miR-423 C>A rs6505162,Homozygotic model,Korea,Asian
Wang,2019,72,240,312,91,206,297,miR-423 C>A rs6505162,Heterozygotic model,China,Asian
Rah,2017,130,232,362,65,149,214,miR-423 C>A rs6505162,Heterozygotic model,Korea,Asian
An,2022,181,581,762,99,463,562,miR-499a A>G rs3746444,Allele model,Korea,Asian
Alipour,2019,153,87,240,97,83,180,miR-499a A>G rs3746444,Allele model,Iran,Caucasian
Stavrou,2018,51,147,198,52,122,174,miR-499a A>G rs3746444,Allele model,Greece,Caucasian
Fazli,2018,104,96,200,74,126,200,miR-499a A>G rs3746444,Allele model,Iran,Caucasian
Beidokhti,2017,114,286,400,116,284,400,miR-499a A>G rs3746444,Allele model,Iran,Caucasian
Parveen,2015,82,318,400,69,531,600,miR-499a A>G rs3746444,Allele model,India,Caucasian
Jeon,2012,131,529,660,64,404,468,miR-499a A>G rs3746444,Allele model,Korea,Asian
An,2022,160,221,381,93,188,281,miR-499a A>G rs3746444,Dominant model,Korea,Asian
Alipour,2019,105,15,120,74,16,90,miR-499a A>G rs3746444,Dominant model,Iran,Caucasian
Stavrou,2018,42,57,99,45,42,87,miR-499a A>G rs3746444,Dominant model,Greece,Caucasian
Fazli,2018,71,29,100,55,45,100,miR-499a A>G rs3746444,Dominant model,Iran,Caucasian
Beidokhti,2017,100,100,200,104,96,200,miR-499a A>G rs3746444,Dominant model,Iran,Caucasian
Parveen,2015,70,130,200,63,237,300,miR-499a A>G rs3746444,Dominant model,India,Caucasian
Jeon,2012,119,211,330,61,173,234,miR-499a A>G rs3746444,Dominant model,Korea,Asian
An,2022,21,360,381,6,275,281,miR-499a A>G rs3746444,Recessive model,Korea,Asian
Alipour,2019,48,72,120,23,67,90,miR-499a A>G rs3746444,Recessive model,Iran,Caucasian
Stavrou,2018,9,90,99,7,80,87,miR-499a A>G rs3746444,Recessive model,Greece,Caucasian
Fazli,2018,33,67,100,19,81,100,miR-499a A>G rs3746444,Recessive model,Iran,Caucasian
Beidokhti,2017,14,186,200,12,188,200,miR-499a A>G rs3746444,Recessive model,Iran,Caucasian
Parveen,2015,12,188,200,6,294,300,miR-499a A>G rs3746444,Recessive model,India,Caucasian
Jeon,2012,12,318,330,3,231,234,miR-499a A>G rs3746444,Recessive model,Korea,Asian
An,2022,21,221,242,6,188,194,miR-499a A>G rs3746444,Homozygotic model,Korea,Asian
Alipour,2019,48,15,63,23,16,39,miR-499a A>G rs3746444,Homozygotic model,Iran,Caucasian
Stavrou,2018,9,57,66,7,42,49,miR-499a A>G rs3746444,Homozygotic model,Greece,Caucasian
Fazli,2018,33,29,62,19,45,64,miR-499a A>G rs3746444,Homozygotic model,Iran,Caucasian
Beidokhti,2017,14,100,114,12,96,108,miR-499a A>G rs3746444,Homozygotic model,Iran,Caucasian
Parveen,2015,12,130,142,6,237,243,miR-499a A>G rs3746444,Homozygotic model,India,Caucasian
Jeon,2012,12,211,223,3,173,176,miR-499a A>G rs3746444,Homozygotic model,Korea,Asian
An,2022,139,221,360,87,188,275,miR-499a A>G rs3746444,Heterozygotic model,Korea,Asian
Alipour,2019,57,15,72,51,16,67,miR-499a A>G rs3746444,Heterozygotic model,Iran,Caucasian
Stavrou,2018,33,57,90,38,42,80,miR-499a A>G rs3746444,Heterozygotic model,Greece,Caucasian
Fazli,2018,38,29,67,36,45,81,miR-499a A>G rs3746444,Heterozygotic model,Iran,Caucasian
Beidokhti,2017,86,100,186,92,96,188,miR-499a A>G rs3746444,Heterozygotic model,Iran,Caucasian
Parveen,2015,58,130,188,57,237,294,miR-499a A>G rs3746444,Heterozygotic model,India,Caucasian
Jeon,2012,107,211,318,58,173,231,miR-499a A>G rs3746444,Heterozygotic model,Korea,Asian
